Key	ClassName	Enabled
ALGAE_COMBASEEC50	insilico.algae_combaseEC50.ismAlgaeCombaseEC50	TRUE
ALGAE_COMBASECLASS	insilico.algae_combaseclass.ismAlgaeCombaseClass	TRUE
ALGAE_EC50	insilico.algae_ec50.ismAlgaeEC50	TRUE
ALGAE_NOEC	insilico.algae_noec.ismAlgaeNOEC	TRUE
AROM_TOX21	insilico.aromatase_activity.ismAromataseTox21	TRUE
AROM_IRMFN	insilico.aromatase_irfmn.ismAromataseIRFMN	TRUE
BCF_ARNOTGOBAS	insilico.bcf_arnotgobas.ismBCFArnotGobas	TRUE
BCF_CAESAR	insilico.bcf_caesar.ismBCFCaesar	TRUE
BCF_KNN	insilico.bcf_knn.ismBCFKnn	TRUE
BCF_MEYLAN	insilico.bcf_meylan.ismBCFMeylan	TRUE
BEE_KNN	insilico.bee_knn.ismBeeKnn	TRUE
CARC_ANTARES	insilico.carcinogenicity_antares.ismCarcinogenicityAntares	TRUE
CARC_ISS	insilico.carcinogenicity_bb.ismCarcinogenicityBB	TRUE
CARC_CAESAR	insilico.carcinogenicity_caesar.ismCarcinogenicityCaesar	TRUE
CARC_ISSCAN-CGX	insilico.carcinogenicity_isscancgx.ismCarcinogenicityIsscanCgx	TRUE
CARCINOGENICTY_FEMALE	insilico.carcinogenicity_rat_female.ismCarcinogenicityRatFemale	TRUE
CARCINOGENICTY_MALE	insilico.carcinogenicity_rat_male.ismCarcinogenicityRatMale	TRUE
CARC_SFI_CLASS	insilico.carcinogenicity_sfi_classification.ismCarcinogenicitySFIClassification	TRUE
CARC_SFI_REGR	insilico.carcinogenicity_sfiregression.ismCarcinogenicitySFIRegression	TRUE
CARC_SFO_CLASS	insilico.carcinogenicity_sfoclassification.ismCarcinogenicitySFOClassification	TRUE
CARC_SFO_REGR	insilico.carcinogenicity_sforegression.ismCarcinogenicitySFORegression	TRUE
CHROM_CORAL	insilico.chromosomal_coral.ismChromosomalAberrationCoral	TRUE
CRAMER_TOXTREE	insilico.cramer_toxtree.ismCramerToxtree	TRUE
DAPHNIA_COMBASE	insilico.daphnia_combase.ismDaphniaCombase	TRUE
DAPHNIA_DEMETRA	insilico.daphnia_demetra.ismDaphniaDemetra	TRUE
DAPHNIA_EC50	insilico.daphnia_ec50.ismDaphniaEC50	TRUE
DAPHNIA_EPA	insilico.daphnia_epa.ismDaphniaEPA	TRUE
DAPHNIA_NOEC	insilico.daphnia_noec.ismDaphniaNOEC	TRUE
DEVTOX_CAESAR	insilico.devtox_caesar.ismDevtoxCaesar	TRUE
DEVTOX_PG	insilico.devtox_pg.ismDevToxPG	TRUE
EW_TOXICITY	insilico.earthworm_toxicity.ismEarthworkToxicity	TRUE
ED_SCREEN	insilico.endocrine_disruptors_irfmn.ismEndocrineDisruptorsIRFMN	TRUE
EYE IRRITATION	insilico.eye_irritation.ismEyeIrritation	TRUE
EYE_IRRITATION_KNN	insilico.eye_irritation_knn.ismEyeIrritationKnn	TRUE
EYE_IRRITATION_SARPY	insilico.eye_irritation_sarpy.ismEyeIrritationSarpy	TRUE
FATHEAD_EPA	insilico.fathead_epa.ismFatheadEPA	TRUE
FATHEAD_KNN	insilico.fathead_knn.ismFatheadKnn	TRUE
FISH_COMBASE	insilico.fish_combase.ismFishCombase	TRUE
FISH_IRFMN	insilico.fish_irfmn.ismFishIRFMN	TRUE
FISH_KNN	insilico.fish_knn.ismFishKnn	TRUE
FISH_LC50	insilico.fish_lc50.ismFishLC50	TRUE
FISH_NIC	insilico.fish_nic.ismFishNic	TRUE
FISH_NOEC	insilico.fish_noec.ismFishNOEC	TRUE
GLUCO_RECEPTOR	insilico.glucocorticoid_receptor.ismGlucocorticoidReceptor	TRUE
GUPPY_KNN	insilico.guppy_knn.ismGuppyKnn	TRUE
HENRY_OPERA	insilico.henryslaw.ismHenrysLawOpera	TRUE
HEPA_IRFMN	insilico.hepatoxicty_irfmn.ismHepatotoxicityIrfmn	TRUE
HYDROLYSIS_CORAL	insilico.hydrolysis_coral.ismHydrolysisCoral	TRUE
KM_ARNOT	insilico.km_arnot.ismKmArnot	TRUE
KOA_OPERA	insilico.koa_opera.ismKoaOpera	TRUE
KOC_OPERA	insilico.koc_opera.ismKocOpera	TRUE
LD50_KNN	insilico.ld50.ismLD50	TRUE
LOEL_LIVER_CORAL	insilico.loael_coral_liver.ismLoaelCoralLiver	TRUE
LOAEL_CONCERT_CORAL	insilico.loael_general_coral.ismLoaelGeneralCoral	TRUE
LOEL_IRFMN	insilico.loel_irfmn.ismLoelIrfmn	TRUE
PPB_LOGK	insilico.logk.ismLogK	FALSE
LOGP_ALOGP	insilico.logp_alogp.ismLogPALogP	TRUE
LOGP_MLOGP	insilico.logp_mlogp.ismLogPMLogP	TRUE
MELTING_POINT	insilico.melting_point.ismMeltingPoint	TRUE
MELTING_POINT_KNN	insilico.melting_point_knn.ismMeltingPointKnn	TRUE
LOGP_MEYLAN	insilico.meylanlogp.ismLogPMeylan	TRUE
MNVITRO_VERMEER	insilico.micronculeus_vitro.ismMicronucleusInVitro	TRUE
MNVIVO_IRFMN	insilico.micronuclueus_vivo.ismMicronucleusInVivo	TRUE
MOA_EPA	insilico.moa_epa.ismMoaEpa	TRUE
MOA_IRFMN	insilico.moa_irfmn.ismMoaIrfmn	TRUE
MUTA_AMINES	insilico.mutagenicity_amines.ismMutagenicityAmines	TRUE
MUTA_ISS	insilico.mutagenicity_bb.ismMutagenicityBB	TRUE
MUTA_CAESAR	insilico.mutagenicity_caesar.ismMutagenicityCaesar	TRUE
MUTA_KNN	insilico.mutagenicity_knn.ismMutagenicityKnn	TRUE
MUTA_SARPY	insilico.mutagenicity_sarpy.ismMutagenicitySarpy	TRUE
NOAEL_LIVER_CORAL	insilico.noael_coral_liver.ismNoaelCoralLiver	TRUE
NOAEL_CONCERT_CORAL	insilico.noael_general_coral.ismNoaelGeneralCoral	TRUE
NOAEL_CORAL	insilico.noel_coral.ismNoaelCoral	TRUE
HEPA_NRF2	insilico.nrf2_up.ismNRF2Up	TRUE
PERS_AIR_CORAL	insilico.persistence_air_coral.ismPersistenceAirCoral	TRUE
PERS_WATER_QUANT	insilico.persistence_quantative_water_irfmn.ismPersistenceWaterQuantitativeIrfmn	TRUE
PERS_SED	insilico.persistence_sediment_irfmn.ismPersistenceSedimentIrfmn	TRUE
PERS_SED_QUANT	insilico.persistence_sediment_quantitative_irfmn.ismPersistenceSedimentQuantitativeIrfmn	TRUE
PERS_SOIL	insilico.persistence_soil_irfmn.ismPersistenceSoilIrfmn	TRUE
PERS_SOIL_QUANT	insilico.persistence_soil_quantitative_irfmn.ismPersistenceSoilQuantitativeIrfmn	TRUE
PERS_WAT	insilico.persistence_water_irfmn.ismPersistenceWaterIrfmn	TRUE
PGP_NIC	insilico.pgp_nic.ismPgpNic	FALSE
HEPA_PPARAUP	insilico.ppara_up.ismPPARAUp	TRUE
HEPA_PPARGUP	insilico.pparg_up.ismPPARGup	TRUE
PPB_CORAL	insilico.ppb_coral.ismPPBCoral	FALSE
HEPA_PXRUP	insilico.pxr_up.ismPxrUp	TRUE
ESTROGEN_CERAPP	insilico.rba_cerapp.ismEstrogenBindingCerapp	TRUE
ANDROGEN_COMPARA	insilico.rba_compara_irfmn.ismAndrogenBindingComparaIRFMN	TRUE
RBA_IRFMN	insilico.rba_irfmn.ismRbaIRFMN	TRUE
READYBIO_IRFMN	insilico.readybio_irfmn.ismReadyBioIRFMN	TRUE
SKIN_CAESAR	insilico.skin_caesar.ismSkinCaesar	TRUE
SKIN_NCSTOX	insilico.skin_cosmetics.ismSkinCosmetics	TRUE
SKIN_IRFMN	insilico.skin_irfmn.ismSkinIRFMN	TRUE
SKIN_IRRITATION	insilico.skin_irritation.ismSkinIrritation	FALSE
SKIN_IRRITATION_CORAL	insilico.skin_irritation_coral.ismSkinIrritationCoral	TRUE
SKIN_IRRITATION_SARPY	insilico.skin_irritation_sarpy.ismSkinIrritationSarpy	TRUE
SKINPERM_POTTS	insilico.skin_permeation_potts.ismSkinPermeationPotts	TRUE
SKINPERM_TENBERGE	insilico.skin_permeation_tenberge.ismSkinPermeationTenBerge	TRUE
SKIN_SENSITIZATION_CONCERT	insilico.skin_sensitization_concert.ismSkinSensitizationConcert	TRUE
SKIN_SENSITIZATION_SARPY	insilico.skin_sensitization_sarpy.ismSkinSensitizationSarpy	TRUE
SKIN_SENSITIZATION_TOXTREE	insilico.skin_sensitization_toxtree.ismSkinSensitizationToxTree	TRUE
SLUDGE_COMBASEEC50	insilico.sludge_combaseEC50.ismSludgeCombaseEC50	TRUE
SLUDGE_COMBASECLASS	insilico.sludge_combaseclass.ismSludgeCombaseClass	TRUE
STERO_OBERON	insilico.steroidogenesis.ismSteroidogenesis	TRUE
TRALPHA_NRMEA	insilico.thyroid_tralpha_nrmea.ismTRAlphaNRMEA	TRUE
TRBETA_NRMEA	insilico.thyroid_trbeta_nrmea.ismTRBetaNRMEA	TRUE
TISSUEBLOOD_INERIS	insilico.tissueblood_ineris.ismTissueBloodIneris	TRUE
TOTALHL_QSARINS	insilico.totalhl_qsarins.ismTotalHLQsarins	TRUE
TPO_OBERON	insilico.tpo_oberon.ismTpoOberon	TRUE
VAPOUR_PRESSURE	insilico.vapour_pressure.ismVapourPressure	TRUE
VERHAAR_TOXTREE	insilico.verhaar_toxtree.ismVerhaarToxtree	TRUE
WS_IRFMN	insilico.watersolubility.ismWaterSolubilityIRFMN	FALSE
ZEBRAFISH_CORAL	insilico.zebrafish_coral.ismZebrafishCoral	TRUE
